NO ./path_to_the_0orth_texture.xpm


SO ./path_to_the_south_texture.xpm
WE ./path_to_the_west_texture.xpm    
EA ./path_to_the_east_texture.xpm


F 100,100,0     

C       1,1,1

 11111111
 100S0011
 10000001
 10000001
 10000001
 10000001
 10000001
 10000001
 10000001
 10000001
 10000001
 10000001
 10000001
 10000001
 10000001
 10000001
 10000001
 10000001
 11111111