NO ./path_to_the_0orth_texture.xpm


SO ./path_to_the_south_texture.xpm
WE ./path_to_the_west_texture.xpm    
EA ./path_to_the_east_texture.xpm


F 100,100,0     

C       1,1,1



1111111111111111111111111111111
1000000000000000000000011    101
1111111111111111111111111111111
11111
1111111111111111111111111
1000100000000000000000011    
1000100000000000000000001
1000100000000000000000001
1000100000000000000000011    
1000010000000000000000001
10000100000000000000000011
100001000N000000000000011    
1000010000000000000000001
1000001000000000000000011
1000001000000000000000011    
1000001000000000000000001
1000001000010000000000001
1000000100000000000000011    
1000000100000100000000001
1000000100000100000001111
1000000100010000000000011    
1000000010000000100000001
1000000010000000000000001
1000000011000110000000011    
1000000011100010000000001
1000000001000010000000001
1000000001000011000000011    
1111111111111111111111111




111111
100001
111111




