NO ./path_to_the_north_texture.xpm


SO ./path_to_the_south_texture.xpm
WE ./path_to_the_west_texture.xpm    
EA ./path_to_the_east_texture.xpm


F 100,100,0    

C       1,1,1   



   
1111111111111111111111111
1000000000000000000N00011
1111111111111111111111111