NO text/no.xpm


SO text/na.xpm
WE ./path_to_the_west_texture.xpm    
EA ./path_to_the_east_texture.xpm


F 255,218,185    

C      240,255,255

    1111111111111111111
    10000000000000000001
    100000000S0000000001
    10000000000000000001
    11111111111111111111