NO text/mona.xpm
SO text/perle.xpm
WE text/van-Gogh.xpm    
EA text/zlij.xpm


F 255,218,185    

C      240,255,255

    1111111111111111111
    10000000000000000001
    100000000N0000000001
    10000000000000000001
    11111111111111111111