NO ./path_to_the_0orth_texture.xpm


SO ./path_to_the_south_texture.xpm
WE ./path_to_the_west_texture.xpm    
EA ./path_to_the_east_texture.xpm


F 100,100,0     

C       1,1,1



       11111
       10001
       10S01
       10001
       11111
